a | al
abandonar | forlasi
abassar | malaltigi
abat | abato
abatessa | abatino
abatter | faligi
abderitano | Abderano
abdicar | abdiki
abdómine | abdomeno
abiete | abio
abiss | abismo
abject | malnobla, fia
abolir | abol(ici)i
abominar | abomeni
abonnament | abono
abonnar | aboni
aborigen | aborigeno
aborter | aborti
abortion | aborto
aboyar | boji
abricot | abrikoto
abrupt | abrupta
abscess | absceso
absent | forestanta
absentie | forest(ad)o
absoluer | absolvi
absolut | absoluta
absorpter | absorbi
absorption | absorb(ad)o
abstinentie | abstineco
abstiner | abstini
abstract | abstrakta
abstraer | abstrakti
absurd | absurda
absurditá | absurd(ec)o
abundantie | abund(ec)o
abundar | abundi
acacie | akacio
acaparar | akapari
accelerar | akceli
accender | (ek)lumigi
accentu | akcento
accentuar | akcenti
acceptabil | akceptebla
acceptar | akcepti
access | aliro
accessibil | alirebla
accessori | akcesora
accessorie | akcesoraĵo
accidente | akcidento
accider | okazi
acerb | acerba
acere | acero
acete | vinagro
acid | acida
acide | acido
aclamar | aklami
aclamation | aklam(ad)o
acomodar | akomodi
acompaniament | akompano
acompaniar | akompani
acord | akordo
acordar | akordi
acri | akra
act | ago
acter | agi
action | agado
action | akcio
actionario | akciano, akciulo
activ | aktiva
activitá | aktiveco
actor | aktoro
actual | aktuala
acuchar | akuŝi
acumular | akumuli
acumulation | akumulo
acurat | akurata
acuratesse | akurateco
acusar | akuzi
acusation | akuzo
acut | akuta
ad | al
adaptar | adapti
adaptation | adapto
addir | adicii
adequat | adekvata
adherer | adheri
adiar | adiaŭi
adío | adiaŭ
adjacer | apudkuŝi, najbari
adjunter | aligi, almeti
adjurar | ĵurpeti
adjustar | ĵustigi
administrar | administri
administration | administracio
administrator | administristo
admirabil | admirebla
admirar | admiri
admisser | allasi
admissibil | allasebla
admonir | admoni
adolescentie | adoleskanteco
adolescer | adoleski
adopter | adopti
adoption | adopto
adorar | adori
adoration | adoro
adplu | aldone
a(d) saver | nome; tio estas
ad u | kien
adular | flati
adulator | flatulo
adult | adolta, plenkreska
adulterar | adulti
adverbie | adverbo
advere | cetere
adversario | kontraŭulo
adversi | kontraŭa
advertiment | averto
advertir | averti
a(d)vocate | advokato
a(d)vocatie | advokateco
aerar | aerumi
aere | aero
afabil | afabla
afabilitá | afableco
afamar | malsati
afectar | afekti
afectation | afekto
afecter | afekcii
afection | afekcio
afere | afero
afiche | afiŝo
afini | afina
afinitá | afineco
afirmar | jesi
aflicter | aflikti
afliction | aflikto
ager | agi
agil | agema
agitar | agiti
agitation | agitado
agnello | ŝafido
agne | ŝafo
agreabil | agrabla
agre | agro
agresser | agresi
agressiv | agresiva
agullie | kudrilo; nadlo
ahocar se | kaŭriĝi
ajornar | prokrasti
alactar | mamnutri, mamigi
alarmar | alarmi
alarme | alarmo
alaude | alaŭdo
albergo | gastejo
alco | alko
alcuam | iel
alcú | ie
alcun | iu
ale | alo; flugilo
alegar | apelacii
alegri | alegra
alert | vigla
aleviar | (pli)faciligi
alie | ajlo
alienar | alieni
alimentar | nutri
allé | aleo
alliantie | alianco
alliar | kunigi
almen | almenaŭ
almosne | almozo
alne | alno
along | laŭlonge
alqual | ia
alquande | iam
alquant | kelkaj
alquel | iu
alquem | ies
alqui | iu
alquo | io
alt | alta
alterar | ŝanĝi
alternar | alterni
altore | alteco
altri | alia
altrimen | alie
aluder | aludi
alun | aluno
amansar | hejmigi
amar | ami
amari | amara
ambassade | ambasado
ambi | ambaŭ
ambicie | ambicio
ambiciosi | ambicia
ambigui | ambigua
ambiguitá | ambigueco
amical | amika
amicitá | amikeco
amico | amiko
amidon | amelo
amore | amo
ampli | ampleksa
amusament | amuzo
amusar | amuzi
analfabete | analfabeto
anate | anaso
anc | ankaŭ
ancian | malnova, longe pasinta
ancor | ankoraŭ
ancre | ankro
anelle | ringo
anexer | aneksi
angel | anĝelo
anguill | angilo
angul | angulo
animale | animalo
animalic | animala
anim | animo
annual | jara
annu | jaro
anse | anso
ante | antaŭ
antenne | anteno
anteriori | antaŭa
antey | antaŭe
anti- | kontraŭ-, anti-
antiqui | antikva
antre | antro
anunciar | anonci
anuncie | anonco
anus | anuso
anxietá | angoro
anxiosi | angora
aparer | ŝajni
aparir | aperi
apart | aparta
apartener | aparteni
ape | abelo
apen | apenaŭ
apert | aperta
aperter | aperti
apiera | abelejo
apiere | abelujo
aplastar | ĉifi
aplauder | aplaŭdi
aplicar | apliki
aplombe | aplombo
apoy | apogo
apoyar | apogi
apreciar | aprezi
aprender | lerni
apretar | apreti
aprobar | aprobi
aprofundar | pliprofundigi
a propó | interalie
apt | taŭga
apu | apud
aqua | akvo
aquar | akvumi
aquavite | brando
áquil | aglo
aquisiter | akiri
arané | araneo
arangear | aranĝi
arbitrage | arbitracio
arbitrari | arbitra
arbitrarie | arbitr(ec)o
arbitro | arbitranto
árbor | arbo
arbuste | arbusto
arcade | arkado
arc | arko
archipelag | insularo
arder | ardi
ardese | ardezo
ardore | ardo
area | areo
argente | arĝento
arguer | argumenti
argumentar | argumenti
arid | arida
arivar | alveni
arlekin | arlekeno
armar | armi
armé | armeo
arme | armilo
armisticie | armisticio
arosear | akvumi
arte | arto
arterie | arterio
articul | artikolo
artisan | metiisto
artise | metio
artist | artisto
ascender | ascendi
ásino | azeno
asparge | aspargo
aspecte | aspekto
aspecter | aspekti
asperser | aspergi
aspirar | aspiri
aspri | aspra
assaltar | ataki
ass | aso
assassinar | murdi
assassination | murdo
assecurantie | asekuro
assecurar | asekuri
assediar | sieĝi
assemblé | asembleo
assentiment | konsento
assentir | konsenti
asserter | aserti
assertion | aserto
assidui | senlaca
assignar | asigni
assignation | asigno
assimilar | asimili
assimilation | asimilado
assistente | asistanto
assister | asisti
assortir | specigi
astonament | mirego
astonar | miregi
astor | akcipitro
astral | astra
astre | astro
astutie | ruzo
astuto | ruzulo
astut | ruza
atacca | atako
ataccar | ataki
atachar | alkroĉi
atavo | praulo
atelar | jungi
ateliere | ateliero
atender | atendi
atentar | atenci
atentate | atenco
atenter | atenti
atention | atento
atinger | atingi
atra(c)tiv | altira
atraer | altiri
atribuer | atribui
atribut | atributo
atroci | abomena, naŭza
aturdir | svenigi
au! | aŭ!
auctionar | aŭkcii
auction | aŭkcio
audaciar | aŭdaci
audacie | aŭdaco
audir | aŭdi
auditor | aŭdanto
augurar | auguri
augur | auguristo
aure | oro
aurin | ora
auripelle | orum(aĵ)o
aurora | aŭroro
austeri | rigora
autentic | aŭtent(ik)a
autun | aŭtuno
auxiliar | helpi
auxiliari | helpa
auxilie | helpo
ava | avino
avan (loc) | antaŭ
avansar | avanci
avanse | avanc(ad)o
avantage | avantaĝo
avantageosi | avantaĝa
avantale | antaŭtuko
avari | avara
avaron | avarulo
avelane | avelo
avelaniero | avelujo
aven | aveno
aventura | aventuro
averse | averso
aviar | aviadi
aviator | aviadisto
avid | avida
avie | birdo
avigilar | veki
avion | avio
avise | avizo
avo | avo
axe | akso
axille | akselo
azur | lazuro
bagage | bagaĝo
balansar | balanci
balansuore | balancilo
bal | balo
balbutiada | balbutado
balbutiar | balbuti
balen | baleno
balenciar | pesi
balencie | pesilo
balle | pilko
balnear | bani
balne | bano
balustrade | balustrado
balyar | balai
balye | balailo
banal | banala
banalitá | banal(ec)o
banca | benko
bandage | bandaĝo
bandar | bandaĝi
band | bendo
baniere | standardo
bank | banko
banniment | elpelo
bannir | elpeli
banquettar | bankedi
banquett | bankedo
baptisa | bapto
baptisar | bapti
barbe | barbo
barbotar | plaŭdvadi
baril | barelo
barilero | barelisto
barre | bariero
basalt | basalto
base | bazo
basic | baza
bass | basa, malalta
bassete | melhundo
bassin | baseno
bastamentar | striki
bastament | striko
basta! | sufiĉas! sufiĉe!
bast | basto
bastion | bastiono
baston | bastono
batte | bato
batter | bati
bavar | bavo
bave | bavi
bayonett | bajoneto
beat | beate
bebé | bebo
becar | beki
becasse | skolopo
bec | beko
bed | bedo
belar | bleki
belladonna | beladono
bell | bela
belvedere | belvedero
bene | bono
benedir | beni
benedition | beno
benevolent | bonvole
benque | kvankam
bentost | baldaŭ
bere | bero
besa | kiso
besar | kisi
besonar | bezoni
beson | bezono
bestial | bestia
bestie | bestio
bete | beto
betul | betulo
bible | biblio
bilie | galo
billet | bileto
bir | biero
birería | bierfarejo
biscuit | biskvito
bivacar | bivaki
bivac | bivako
blagar | blagi
blamar | mallaŭdi
blanc | blanka
blancospine | rozbero
blasar | malakrigi
blasfemar | blasfemi
blatte | blato
blin | blino
blocar | bloki
bloc | bloko
blu | blua
bluse | bluzo
bocca | buŝo
bollir | boli
bon | bona
bonna | vartistino
borde | bordo
borgeso | burĝo
borse | burso
bosco | bosko
bosillar | faraĉi, fuŝi
bosse | ĝibo
bote | boato
bove | bruto
boy | bubo
boye | buo
brac | fuŝprodukto
braconar | ŝtelĉasi
braconero | ŝtelĉasisto
brambere | frambo
branche | branĉo
branchie | branĥo, branko
brandisser | svingi
brandy | brando
brane | brano
brase | ardo
brasse | brako
brasselett | braceleto
brav | brava
bravura | bravuro
breche | breĉo
brevi | mallonga
bride | brido
brilliar | brili
brique | briko
brise | blovete
broche | broĉo
brodar | brodi
brodular | bruboli
bronchie | bronko
bronne | puto
brossar | broŝi
bross | broŝo
brove | brovo
bruir | brui
brular | bruli
brun | bruna
brusqui | bruska
brutal | brutala
brute | bruto
brutto | brutte
buchar | buĉi
bucle | buklo
buc | virkapro
budar | nubmieni
buffon | bufono
bulbe | (okul)bulbo
bul | bulo
bulletin | bulteno
burdon | burdo
burgeon | burĝono
burlesc | burleska
buró | buroo
bursa | borso
buste | busto
butica | butiko
buton | butono
buttre | butero
bux | kesto
cabane | kabano
cabine | kajuto, ĉambreto
cable | kablo
cabrar | baŭmi
ca | ĉu
cadavre | kadavro
cader | fali
caderne | kajero
cadre | kadro
caduc | kaduka
cage | kaĝo
calabron | krabro
calambure | ludrimo, vortludo
cálame | kalamo
calamitá | plago
calcan | kalkano
calce | kalko
calcular | kalkuli
calcul | kalkulo
caldiere | vaporkaldrono
caldron | kaldrono
calentar | hejti
calentation | hejtado
caler | varmi
calid | varma
calle | kalo
calm | kalma
calore | varmo
calorie | kalorio
calson | kalsono
calumniar | kalumnii
calumnie | kalumnio
calve | kalvo
calvi | kalva
camarado | kamarado
cambio | kambio
camel | kamelo
cámera | kamero
camin(e) | kameno
camise | ĉemizo
campania | kamparo
campanie | kapanjo
campar | kampi
camp | kampo
cánabe | kanabo
cane | hundo
canello | hundido
canif | poŝtranĉilo
canne | kano
cannel | kanelo
cantar "cucú" | kukoli
cantarell | kantarelo
cantar | kanti
canzon | kanzono
capabilitá | kapabl(ec)o
capabil | kapabla
capacitá | kapacito
capella | kapelo
capille | haro
capistrap | jugo
capital | ĉefa
capitale | kapitalo
capitele | kapitelo
capitul | ĉapitro
cap | kapo
caporale | kaporalo
capote | kapoto
cappe | ĉapo
cappon | kapono
capre | kapro
capreol | kapreolo
capricie | kaprico
capsul | kapsulo
capter | kapti
carbon | karbo
carcere | karcero
cardul | kardelo
carema | fasto
caremar | fasti
caressar | karesi
caresse | kareso
cargar | kargi
cargo | kargo
caricar | kariketuri
caricature | kariketuro
carir | malhavi, sent1 mankon
car | kara
carnage | massacre
carne | karno
carnevale | karnavalo
carnivori | karnivora
carotte | karoto
carpe | karpo
carpentar | carpenti
carpentero | carpentisto
carpino | karpeno
carrear | veturi
carrel | kahelo
carrette | ĉaro
carre | veturilo
carte | karto
cascade | akvofalo
casco | kasko
caseo | fromaĝo
caserne | kazerno
cassar | nuligi
casse | kaso
castell | kastelo
castor | kastoro
castrar | kastri
casu | kazo
cataracte | katarakto
caten | kateno
cat | kato
caude | vosto
cauliflor | florbrasiko
caulirap | brasikrapo
caul | sabeliko
causar | kaŭzi
cause | kaŭzo
caustic | kaŭstika
caution | kaŭcio
caut | singarda
cava | kavo
cavalcade | kavalkado
cavalcar | kavalkadi
cavaliero | kavaliro
cavall | ĉevalo
caverne | kaverno
cavi | kava
caye | kajo
ccnvex | konveksa
cebul | cepo
celar | cedi
celar | kaŝi
celebrar | celebri
celebri | celebra
cellul | celulo
cellulose | celulozo
censer | cenzuri
censor | cenzuristo
censu | censo
censura | cenzuro
cent | cent
centene | cento
centesim | centa
centfolie | centifolio
centimetre | centimetro
central | centra
centrale | centralo
centre | centro
cereales | cerealoj
cerebral | cerba
cerebre | cerbo
cerese | ĉerizo
cernar | ĉirkaŭigi
cert | certa
certitá | certeco
cerva | cervino
cervo | cervo
cervulade | cervelaso
cessar | ĉesi
ceteri | cetera
chac | ŝako, ŝakon!
chagrirar | ĉagreni
chagrire | ĉagreno
chalumel -ŝalmo
chambre | ĉambro
chamuse | ĉamo
chancelar | ŝanceli
chance | ŝanco
change | ŝanĝo
chap | bravulo
chapel | ĉapelo
charge | ŝarĝo
charitá | bonfarado
charme | ĉarmo
charnire | pordhoko
charpe | skarpo
charpie | ĉarpio
charta | ĉarto
chascun | ĉiu
chassar | ĉasi
chassero | ĉasisto
chast | ĉasta
che | ĉe
chef | ĉefo
chest | kesto
chicanar | cikani
chicane | cikano
chifon | ĉifono
chimene | fumtubo
chiripar | ĉirpi
choc | ŝoko
chosse | ŝoseo
chuchotar | flustri
cible | celtabulo
cicatre | cikatro
ci | ĉi tie
cicoré | cikorio
ciec | blinda
ciecitá | blindeco
ciel | ĉielo
cil | cilio
cime | verto
cimice | cimo
ciname | cinamo
cindre | cindro
cinter | zoni
cintura | zono
circa | cirkaŭ
circul | rondo, (geom.) cirklo
circum | ĉirkaŭ
circumear | ĉirkaŭiri
circumstantie | cirkonstanco
cire | vakso
cisel | cizilo
ciser | tratranĉi
cisores | tondilo
cité | urbo
cive | civitano
claffar | boji
clamar | klami
clapp | klapo
clarificar | klarigi
clar | klara
classe | klaso
classic | klasika
classico | klasikulo
claudicar | lami
clave | klavo, ŝlosilo; ĉano; kleo
clement | milda
cliff | klifo
climbar | grimpi
clinc | klinko
cline | deklivo
clini | dekliva
cliquettar | tintegi
clob | klabo
clocca | horo
clochear | sonorigi
cloche | sonorilo
clove | najlo
cluder | fermi
cobold | koboldo
cochemare | inkubo, terursonĝo
cocina | (= cocinería) kuirejo
cocinar | kuiri
cocinería | (= cocina) kuirejo
cocinero | kuiristo
coclare | kulero
code | kodo
coidealist | samideano
coincider | koincidi
colaborar | kunlabori
colare | kolumo
colecter | kolekti
colection | kolekto
colerar | koleri
colere | kolero
colider | kolizii
colier | rikolti
coline | monteto
colision | kolizio
col | kolo
colle | lignaĝa gluo
colon | dupunkto
colonnade | kolonaro
colonne | kolono
colorar | kolori
color | koloro
colp | bato
colubre | kolubro
columbe | kolombo
combatter | kunbatali
combuster | forbruligi
comendar | sendi
comensar | komenci
comercie | komerco
cometter | estigi, fari
comic | komika
comico | komikulo
comisser | komisii
comission | komisio
comité | komitato
comma | komo
commí | komizo
comod | komforta
compact | kompakta
compane | kompano
companie | kompanio
comparar | kompari
comparation | komparo
comparative | komparativo
compatiment | kompato
compatir | kompati
compatriot | samlandano
compensar | kompensi
compensation | kompensado
competir | konkuri
competition | konkurado
compleer | kompletigi
complement | komplemento
compleser | komplezi
complet | kompleta
complicar | kompliki
complicst | komplika
complot | komploto
composir | komponi
composition | komponaĵo
composter | komposti
comprar | aceti
comprender | kompreni
comprensibil | komprenebla
comprometter | kcmpromiti
compromisser | kompromisi
compromiss | kompromiso
computar | komputi
computator | komputoro
comto | grafo
comune | komunumo
comunicar | komuniki
comunication | komunikaĵo
comunion | komunio
comun | komuna
comutar | komuti
comutator | komutilo
concav | konkava
conceder | koncesii
concepter | 1.koncepti 2. koncipi
concerner | koncerni
concession | koncesio
conche | konko
concis | konciza
concluder | konkludi
conclusion | konkludo
concordar | konkordi
concordie | konkordo
concurrentie | konkurenco
concurrer | konkurenci
condamnar | kondamni
condensar | kondensi
condiment | kondimento
conditionale | kondicionalo
condition | kondiĉe
condoler | kondolenci
conducter | konduki, konbukti
conduida | konduto
conduir | konduti
conecter | konekti
cone | konuso
conexer | interligi, koneksi
conferer | interkosiliĝi
confesser | konfesi
confider | konfidi
confine | limo
confirmar | konfirmi
confiter | konfiti
conform | konforma
confrontar | konfronti
confuser | konfuzi
congelar | kongeli
congruer | kongrui
conic | konusa
conifere | konifero
conjecter | konjekti
conjugar | konjugi
conjuncter | kunligi
conjunter | kunligi
conjurar | ĵurpeti
con | kun
conosser | koni
conquestar | konkeri
consacrar | konsekri
conscientie | konscienco
consentir | konsenti
consequentie | konsekvenco
consequent | konsekvenca
conservar | konservi
considerar | konsideri
consiliar | konsili
consister | konsisti
consolar | konsoli
consonant | konsonanto
conspirar | konspiri
constant | konstanta
consterner | konsterni
constipar | konstipi
constipation | konstipo
constituer | kcnstitui
constitution | konstitucio
constricter | konstrikti
constructer | 1.konstrui 2.konstrukti
consultar | konsulti
consumar | konsumi
consum | konsumo
consumpter | konsumi; eluzi
contact | kontakto
contant | kontanta
contene | enhavo
contener | enhavi
content | kontenta
contestar | kontesti
continuar | kontinui
continui | kontinua
conto | konto
contore | kontoro
contrabandar | kontrabandi
contrabande | kontrabando
contra(ct)er | kontrakti
contra | kontraŭ
contribuer | kontribui
contrir | aflikti
contura | konturo
contuser | kontuzi
contusion | kontuz(aĵ)o
convalescentie | konvalesko
convalescer | konvaleski
convener | koveni
convenir | kunveni
conventer | konventi
converger | converĝi
conversar | konversacii
conversation | konversacio
converter | konverti
convicter | konvikti
convoy | konvojo
cope | pokalo
corage | kuraĝo
corageosi | kuraĝa
corb | korbo
corc | korko
corde | kordo
cordial | kora
cordie | koro
corecter | korekti
corect | korekta
corector | korektisto
corectura | korektaĵo
corelativ | koreletiva
corespondentie | korespondaĵo
coresponder | korespondi
cor | ĥoro
coridor | koridoro
cornamuse | sakfajfilo, sakfluto
cornea | korneo
cornille | korniko
corn | korno
coron | korono, krono
corpo | korpuso
córpor | korpo
corpulent | korpulenta
corsage | korsaĵo
corsete | korseto
corte | korto
cortice | ŝelo
cortine | kurteno
coruir | kolapsi
corupter | korupti
coruption | korupt(ad)o
corvo | korvo
cose | aĵo
cosmic | kosma
cosmo | kosmo
coste | 1.ripo 2.bordo
costume | kostumo
coton | kotono
covar | kovi
covert | koverto
covriment | kovrilo
covrir | kovri
cramp | kramfo
crampon | krampo
cran | gruo (maŝino)
cranio | kranio
crayon | krajono
crear | krei
creation | kre(ad)o
crede | kredo
creder | kredi
credeter | krediti
credet | kredito
crem | kremo
crepar | krepiti
crepuscul | krepuskulo
crescer | kreski
crest | kresto
crete | kreto
cretino | idioto
crevar | krevi
creve | kankro
criar | krii
cribell | kribrilo
crida (falliment) | bankroto
cri | krio
criminard | krimulo
crímine | krimo
crine | krino
crochetar | kroĉeti
crochet | kroĉetilo
croc | hoko
cropp | kropo
cruce | kruco
cruche | kruĉo
cruc | lambastono
crud | kruda
cruel | kruela
crumel | panmolo
crure | krura
crusbere | ribo
cruste | krusto
cuande | kiam
cube | kubo
cubic | kuba
cucombre | kukurbo
cucú | kukolo
cude | kubuto
cuida | zcrgo
cuider | zcrgi
cúlmine | kulmino
culpa | kulpo
cultel | tranĉilo
cultivar | kultivi
cúmine | kumino
cumul | amaso
cumular | amasigi
cuneo | kojno
cunicul | kuniklo
cupar | tranĉi, tondi
cupid | profitema
cupol | kupolo
cupre | kupro
cura | kuraco
curar | kuracadi
curasse | kiraso
curiosi | scivola; kurioza
currer | kuri
curt | kurta
curve | kurbo
curvi | kurba
cusina | kuzino
cusino | kuzo
cussine | kapkuseno
custar | kosti
customar | kutimi
custom | kutimo
cute | ledo
cicle | ciklo
cycle | v. cicle
ciclon | ciklono
cyclon | v. ciclon
cygne | v. cigne
cypress | v. cipress
damagear | damaĝi
damage | damaĝo
damnar | damni
damnation | damno
dangere | danĝero
dangerosi | danĝera
dansa | danco
dansar | danci
dar | doni
date | dato
datil | daktilo
dax | melhundo
debil | debila, malforta
debir | ŝuldi
debochar | diboĉi
decader | dekadenci
decepter | elrevigi
decer | deci
deci | dek
decider | decidi
decision | decido
declarar | deklari
declinar | deklinacii
declivar | deklivi
declive | deklivo
decocter | dekokti
decoltar | dekolti
decovrir | malkovri
de | de
dedicar | dediĉi
Deessa | Diino
defender | defendi
deformar | deformi
deformation | deformado
defraudar | defraŭdi
degelar | degeli
dejorar | deĵori
dejunar | matenmanĝi
deliberar | debati
delicie | delico
delirar | deliri
demandar | peti
deman | morgaŭ
dement | freneza
dementir | dementi
demí- | duon-
demí | duono
demolir | malkonstrui
denov(e) | denove
densi | dense
dentage | dentaro
dente | dento
dentelle | punto
Deo | Dio
depender | dependi
deplorar | priplori
depó | deponejo
depoy | de tiu tempo
depravar | senmoraligi
depresser | malĝojigi, deprimi
derider | moki
derivar | derivi
derma | dermato
descender | descendi
desde | de post
desert | dezerta
deserte | dezerto
deserter | dizerti
desertor | dizertinto
desilusion | seniluziiĝo
desirar | deziri
desire | deziro
dessert | deserto
dessinar | desegni
dessine | desegnaĵo
destinar | destini
destructer | detrui
detallie | detal(aĵ)o
detecter | detekti
detra | malantaŭen
de u | de kie
devastar | dezertigi
developar | evoluigi
devenir | fariĝi
dever | devi
devise | devizo
devoet | sindona
devorar | devori
dextri | dekstra
diabete | diabeto
diabol | diablo
die | tago
difamar | senhonorigi
diga | digo
digester | digesti
digital | diĝita
digni | inda
dilatar | dilati
diligent | diligenta
diligentie | diligenteco
dill | aneto
diluer | dilui
diluvie | diluvo
diminuer | dimimui, etigi
dinear | tagmanĝi
diné | tagmanĝo
dir | diri
directer | direkti
disciplo | disĉiplo
discurs | diskurso
discusser | diskuti
disparat | diversspeca, heterogena
disperser | dispersi
disposir | dispozicii
dissipar | disigi, elspezi
distar | distanci
distinter | distingi
districte | distrikto
diverger | diverĝi
diversi | diversa
divertisser | amuzigi
divider | dividi
divinar | diveni
divin | dia
divorciar | divorci
divulgar | diskonigi
doane | dogano
docer | instrui
docil | perceptema
doler | dolori
dolore | doloro
domestic | hejma, malsovaĝa
domino | mastro
domitar | bridi
don | donaco
dorlotar | dorloti
dormir | dorsi
dorse | dorso
dot | doto
dozen | dekduo
drachar | draŝi
dracon | drako
drama | dramo
dramatic | drama
drap | drapo
drenar | dreni
dresser | dresi
dressura | dresado
drolli | drola
dubitar | dubi
duche | duŝo
ducter | gvidi
ductor | gvidanto
du | du
dulci | dolĉa
dunc | do, sekve, tial
dupo | dupo
durar | daŭri
dur | malmola
ear | iri
ebrie | ebria
ebrietá | ebri(ec)o
eclesia | preĝejo
eclesie | eklezio
ecoar | eĥiĝi
eco | eĥo
economie | ekonomio
ecran | ekrano
edict | edikto
edificar | edifi
edificie | konstruaĵo
editer | eldoni
educar | eduki
efaciar | (for)viŝi
efect | efekto
efectuar | efektivigi
egal | egala
ejecter | elĵeti
e | kaj
electer | elekti
elefant | elefanto
element | elemento
elev | lernanto
elite | elito
eloquent | elokventa
emanar | emani
embarass | embaraso
emendar | plibonigi
emerger | emerĝi
emerit | enerita
emfase | emfazo
emgirar | emigri
eminer | elstari
emisser | emisii
emotion | emocio
employar | okupigi
enigma | enigmo
enorm | enorma
enoyar | enuigi
enoyar se | enui
ente | estaĵo, estulo
entender | akordiĝi
enunciar | elparoli
episcop | episkopo
epistul | epistolo
epol | ŝultro
erecter | erekti
eremit | ermito
ergo | do
erica | eriko
erra | eraro
eruca | raŭpo
erudir | erudi
erudito | erudito
erupter | erupcii
escapar | eskapi
escutar | aŭskulti
espade | spado
esperar | esperi
esprite | spritaĵo
esquisse | skizo
essay | eseo
esser | esti
estimar | estimi
estive | somero
estuche | ujo
etá | aĝo
etablissement | establ(aĵ)o
etablisser | establi
etage | etaĝo
eterni | eterna
etsí | v. benque
eufonie | eŭfonio
evacuar | evakui
evanescer | sveni
evenir | okazi
evident | evidenta
evitar | eviti
evoluer | evolui
evolution | evolu(ad)o
exact | ekzakta
exagerar | troigi
examinar | ekzameni
examine | ekzameno
exceder | ekscesi
excepter | escepti, eligi
excerpter | ekstrakti, elscribi
excession | eksceso
excitar | eksciti
excluder | ekskludi
excusar | ekskuzi
executer | ekzekuti
ex | el
exemple | eksemplo
exempter | eligi, liberigi
exercir | ekzercii
exhauster | elĉerpi
exhortar | admoni, instigi
exiger | postuli
exilie | ekzilo
exister | ekzisti
expander | ekspansii
expansiv | ekspansia
expectar | ekspekti
expedir | ekspedi
expense | elspezo
experientie | sperto
experir | sperti
expiar | penti
expirar | ekspiri
explicar | ekspliki
explorar | esplori
explotar | ekspluati
exposir | ekspozicii
expresser | esprimi
expulser | elpeli
exquisir | elekti
extender | etendi
exteriori | ekstera
exterminar | ekstermi
externi | ekstera
extinter | estingi
extirpar | disrabi
extra | exter
extran | fremda
exuberar | abundege kreski
exultar | ĝojkrii, jubili
fabe | fabo
fabul | fabulo
facie | vizaĵo
facil | facila
facilitá | facileco
fact | fakto, faro
factura | fakturo
fad | malbongusta
fago | fago
falce | falĉilo
falcon | folko
fallir | mistrafi
fals | falsa
fama | famo
fame | malsato
fantom | fantomo
fare | lumturo
far | fari
farine | faruno
farse | farso
faruchi | sinĝena, timema
fasan | fazano
fasce | fasko
fascinar | fascini
fate | fatalo
fatiga | laceco
fauce | faringo, gorĝo
favor | favoro
fea | feino
febre | febro
fec | feko
fecultativ | fakultativa
fecund | fekunda
federal | federala
federe | federo
felici | feliĉa
felicitar | bondeziri, gratuli
feltre | felto
femina | virino
femur | femuro
fender | fendi
fenestre | fenestro
fen | fojno
ferie | foiro
feroci | feroca, kruela
ferre | fero
fertil | fruktodona
fervent | fervora
ferver | fervori
fervore | fervoro
festa | festo
festine | festeno
feston | festono
feter | fetori
fetid | fetora
feto | feto
feudal | feŭda
feude | feŭdo
fible | fibolo
fibre | fibro
ficter | fikcii
fictiv | fiktiva
fidel | fidela
fider | fidi
filar | fadenigi
fil | fadeno
filia | filino
filice | filiko
filio | filo
filú | petolulo
fin | delikata
fine | fino
fingre | fingro
finir | fini
firm | firma
fix | fiksa
flac | flako
flad | flano
flagellar | vipi
flagga | flago
flamme | flamo
flanar | maldillgentaĉi
flanca | flanko
flarar | flari
flattar | flati
fleche | sago
flexer | fleksi
flicca | bubino, knabino
floc | floko
flor | floro
fluer | flui
flut | alfluo
fluvie | rivero
foco | fokuso
folie | folio
folli | fola
fonder | fandi
fonte | fonto
forar | bori
forator | borilo
foren | fremda, fremdlanda
forest | arbaro, forsto
fore | truo
for | for
forjar | forĝi
formíca | formiko
forne | forno
forrage | furaĝo
forsan | eble
fort | forta
fortiar | devigi, trudi
fortie | forto
fortun | fortuno
foss | foso
fox | vulpo
foy | fajro
fracassar | brui
fracasse | bruo
fracter | rompi
fragil | fragila
franc | malkaŝa, rekta, sincera
francmasson | framasono
frange | franĝo
frappar | frapi
frasbere | frago
fratre | frato
fraude | trompo
frecuent | ofta
frenar | bremsi
fren | bremso
friar | frakasi
fricter | froti
frigid | frida, frigida
frir | friti
frisc | friska
friser | frizi
frivol | frivola
front | fronto
frossar | ĉifi
frost | frosto
frottar | froti
fructe | frukto
frufruar | susuri
frugal | modera
frument | tritiko
frustrar | senigi
fugir | fuĝi
fulgurar | fulmobrili
fulguretion | fulmobrilo
fulígine | fulgo
fúlmine | fulmo
fumer | fumi
fum | fumo
fumicar | fumumi
fundar | fondi
funde | fundo
funel | funelo
funerale | sepulto
fune | ŝnuro
funest | fatala
fungo | fungo
furbon | fripono
furca | forko
furer | furiozi
furgon | furgono
furiosi | furioza
furnir | liveri
furtero | ŝtelisto
furter | ŝteli
fuser | kunfandiĝi, kunflui
fusilar | fusili
fusil | fusilo
futil | senvalora
future | futuro
futur | futura
gage | lombardo
galaxe | galaksio
galere | galero
gallina | kokino
galop | galopo
gambale | bottrunko
gambe | gambo
ganie | gajno
ganse | ansero
gapar | gapi
garantiar | garanti
garantie | garanto
garbe | garbo
gardar | gardi
garnir | garni
garson | junulo; kelnero
gast | gasto
gaudie | gajeco, ĝojo
gay | gaja
gazette | gazeto
gazon | gazono
gela | frosto
gelar | frosti
gelé | gelatenaĵo, ĵeleo
gemelle | ĝemelo
gemir | ĝemi
genar | ĝeni
genere | genro
generosi | grandanima, nobla
geniter | generi, naski
genitores | gepatroj
gente | ganto
gente | gento
gentil | ĝentila
genú | genuo
genuin | ĝusta
germinar | ĝermi
germine | ĝermo
gigant | giganto
gilet | veŝto
gips | gipso
glacie | glacio
glaciero | glacimonto
gladie | glavo
glande | glano
glandul | glando
glass | glaso
glatt | glata
gleb | glebo
glissar | gliti
globe | globo, globuso
glorie | gloro
glotir | gluti
glutinar | glui
glutine | gluo
golf | golfo
governar | eduki
governessa | edukistino
gracil | gracila
gradu | grado
grafite | grafito
grand | granda
grandissim | grandega
gran | grajno
grasse | graso
grass | grasa
grat | dankema
grattar | grati
gratuit | senpage
graver | gravuri
gravero | gravuristo
grav | grava
gravid | graveda
gravio | gruzo
grel | hordea grio
griffe | ungego
grillio | grilo
grill | rostostango
grimar | ŝminki
grimpar | grimpi
grinar | grimaci
grinsar | grinci
gris | griza
grive | ĉagreno
grue | gruo
gruel | grio
grunnir | grumbli
gruppe | grupo
guardie | gard(ad)o
gudron | gudro
guerre | milito
guidar | gvidi
guitarre | gitaro
gumme | gumo
gurmand | gastronoma
gust | gusto
gutte | guto
gutur | gorĝo
guvernar | regi
guvernero | reganto
habil | capabla, lerta
habitant | loĝanto
habitar | loĝi
habitu | kutimo
hacca | hakfosilo
hache | hakilo
hag | barilo, ĉirkaŭbarilo
hala | spiro
halde | amaso
hall | halo
haltere | haltero
halt! | haltu!
hamac | hamako
hamstre | hamstro
hanche | kokso
happar | kapti
hareng | haringo
harness | ĵungaĵo, ĵungilaro
harpe | harpo
hasard | hazardo
hauster | ĉerpi
haver | havi
hay | estas, ekzistas
hedre | hedero
helice | helico
helm | helmo
hem | hejmo
hepate | hepato
herbe | herbo
heredar | heredi
heresie | herezo
heretico | herezulo
hernie | hernio
heróe | heroo
heron | ardeo
herriser | hirtiĝi
hersar | erpi
herse | erpilo
hesitar | heziti
hiar | oscedi
hiccar | singulti
hideosi | hida
hinnir | hini
hirar | lui
hirunde | hirundo
hiverne | vintro
hoccar | kaŭri
hodie | hodiaŭ
homanité | homaro
hom | homo
honest | honesta
honor | honoro
honte | honto
hora | horo
hora | horo (sur horloĝo)
horde | hordo
hordeo | hordeo
hor | horo (60 min)
horloge | horloĝo
horrer | horori
horrore | hororo
hosped | gastiganto
hostil | malamika
huf | hufo
humid | humida
humil | humila
humo | humo
humor | (bon)humoro, humuro
idé | ideo
identic | identa
idioma | idiomo
idol | idolo
ili | ili
il | li
iluminar | ilumini
image | bildo
imaginar | imagi
imagine | imago
imens | grandega, senmezura
imitar | imiti
impedir | ĝeni, malhelpi
imperar | ordoni
imperator | imperiestro
imperie | imperio
impetuosi | impeta
implorar | (al)voki, peti pri helpo
important | grava
imposant | inpona
imposar | inponi
impost | imposto
impresser | impresi
impression | impreso
imputar | imputi
inaugurar | inaŭguri
inauguration | inaŭguro
inballar | enpaki
inbrassar | brakumi, ĉirkaŭbraki
incendie | incendio, brulego
incense | incenso
incitar | inciti
inclinar | inklini
includer | inkludi
incontrar | renkonti
incre | inko
incude | inkudo
index | indekso, (mat.) indico
indicar | indiki
indigene | indiĝeno
indigen | indiĝena
indiger | malhavi
indignation | indigno
indolent | mallaborema
indulger | indulgi
industrie | industrio
in | en
inept | mallerta; nekonvena
inert | inerta
infallibil | senerara
infam | senhonta
infante | infano
infecter | infekti
inferiori | neplenvalora
inferne | infero
inflammar | (ek)bruligi
inflammette | alumeto
inflar | plenblovi
inflation | inflacio
influentie | influo
influent | influa
influer | influi
infra | malsupre
infuser | infuzi
ingredientie | almiksaĵo
ingredir | almiksi
inhalar | inhali
inhibir | inhibicii
iniciar | iniciati
iniciative | iniciato
injurie | maljustaĵo
innocent | senkulpa
inocular | inokuli
inprofundar | pliprofundigi
inquestar | demandar, esplori
inquisiter | enketi
insecte | insekto
insidiar | insidi
insigne | insigno
insinuar | enŝovi
insister | insisti
insolation | insolacio
insolent | insolenta
inspecter | inspekti
inspection | inspekto
inspirar | inspiri
installar | instali
installation | instalo
instigar | instigi
instituer | starigi
institution | institucio
instructer | instrui
instructor | instruisto
instrument | instrumento
insul | insulo
insultar | insulti
insurection | insurekcio
intact | netuŝita
integri | integra
intelectu | intelekto
inteligentie | inteligenteco
inteligent | inteligenta
intensitá | intenseco
intensiv | intensa
intenter | intenci
intention | intenco
intercalar | enmeti, enŝovi
interdicter | malpermesi
interdict | malpermeso
interessant | interesa
interessar | interesi
interesse | intereso
interest | interezo, procentaĵo
interim | intertempe
inter | inter
interiori | interna
intern | interna
interprender | interpreni
interpretar | interpreti
interprete | interpretisto
interpunction | interpunkcio
interrupter | inter(rupt)i
intestine | intesto
intim | intima
intonar | intonacii
intra | interne
intrar | eniri
intrica | intrigo
introducter | enkonduki
intuition | intuicio
inundar | inundi
invader | invadi
invelopar | envolvi
inventer | inventi
inversi | inversa
investigar | esplori, serĉi
investir | investi
inviar | sendi
invidie | envio
invitar | inviti
iride | irido
irigar | irigacii
iris | iriso
iritar | iriti
irupter | fari enrompon
istme | istmo
iterar | reciproki
it | ĝi
jacer | kuŝi
jalusie | ĵaluzo
jalusi | ĵaluzi
jamá | iam, foje
jambon | ŝinko
jaque | ĵaketo
jardin | ĝardeno
jettar | ĵeti
jocar | ŝerci
joc | ŝerco
jolli | bel(et)a
jonglar | ĵongli
jovedí | ĵaŭdo
jovial | bonanim(ec)a
joya | ĝojo
joyar | ĝoji
jubilar | jubili
judicar | juĝi
judico | juĝisto
juida | ĝuo
juir | ĝui
julí | julio
junio | junio
junter | kunigi
junt | kune
jup | jupo
jurament | ĵuro
jurar | ĵuri
jure | juro
jurist | juristo
jurnale | ĵurnalo
jurnalist | ĵurnalisto
justicie | justeco
just | ĵus; ĝusta; justa
juvel | juvelo
kalium | kalio
kepi | kepo
khan | ĥano
kil | kilo
knut | vipo
labie | lipo
labil | labila
laborar | labori
labore | laboro
lacayo | lakeo
lacear | laĉi
lace | laĉo
lacerar | disŝiri
laconic | lakona
lacrimar | larmi
lácrime | larmo
lacte | lakto
lacune | interspeco
lade | lado
lago | lago
lame | klingo
lamentar | lamenti
land | lando
lane | lano
languir | soifi
lanse | lanco
lápid | ŝtono
lappar | flik(aĵ)i
lapp | flik(aĵ)o
larde | lardo
larg | larĝa
lasciv | lasciva
la | ŝin
lassar | lasi
látere | flanko, (geom.) latero
latitudine | latitudo
latte | lato
latug | laktuko
latun | latuno
laudar | laŭdi
laude | laŭdo
laure | laŭro
lavage | lavado
lavar | lavi
lax | neglektema
leccar | leki
lecion | leciono
lection | lekcio
leder | difekti
leer | legi
legal | leĝa, laŭleĝa
lege | leĝo
legion | legio
legume | legomo
le | lin
lentige | lentugo
lentille | lento
lent | lanta, malrapida
leon | leono
lepra | lepro
les | ilin, al ili
letor | leganto
lette | lito
lettre | letero
levar | levi
leven | gisto
levere | levilo
levi | malpeza
levul | maldekstra
lexico | vortaro
ley | v. lege
libre | libro
librería | librovendejo
licer | lici
lichen | likeno
liga | ligo
ligar | ligi
ligne | ligno
lignin | ligna
li | la
lila | lila; (bot.) siringo
limitar | limigi
limite | limo
limpid | klara
linar | fajli
lineale | liniilo
linea | linio
linear | linii
line | fajlilo
lingual | lingva
lingue | lingvo
linin | lina
lin | lino
linse | lenso
liquide | fluidaĵo
liquid | fluida
liste | listo
litt | malgranda
liverar | liveri
livid | mortpala
lixive | lesivo
lob | lobo
local | loka
locar | loki
loco | loko
logiar | loĝi
logí | loĝejo
longitudine | longitudo
long | longa
longore | long(ec)o
lontanie | malproksimo
lontan | malproksima
lor | ilia
lotar | loti
lot | loto
luar | lui
luator | luanto
lubrificar | lubriki
luce | lumo
lucer | lumi
lucrar | lukri
lucte | lukto
lucter | lukti
lude | ludo
luder | ludi
ludette | ludilo
lullar | luli
lulluore | lulilo
lunari | luna
lunedí | lundo
lune | luno
lupo | lupo
lurar | logi
lure | logaĵo
luxar | elartikigi, luksacii, tordi
luxu | lukso
luxuosi | luksa
macerar | maceri
machar | maĉi
machine | maŝino
machuore | makzelo
macular | makuli
macul | makulo
magnanim | grandanima
magnific | grsndioza
magri | magra
mai | majo
mais | maizo
maladie | malsano
malad | malsana
malgré | malgraŭ
malicie | malico
mal | malbona
malt | malto
mamá | panjo
mamme | mamo
mammifere | mambesto
manca | manko
mancar | manki
manche | maniko
manchette | manumo
mandar | mendi
mandul | migdalo
maner | resti
manglar | kalandri
mangle | kalandro
maniere | maniero
mani | multa(j)
manjage | manĝ(aĵ)o
manjar | manĝi
mannic | vira
mann | viro
mansar | mildigi
mansi | milda
mantel | mantelo
manuale | manlibro, instrulibro
manual | mana
manu | mano
marca | marko
marcer | marki
marcha | marŝo
marchar | marŝi
mardí | mardo
mare | maro
marginel | marĝena
margine | marĝeno
marinero | maristo
marin | mara
marionette | marioneto
marita | edzino
marito | edzo
marmor | marmoro
marodar | ŝtelĉasi
marodero | ŝtelĉasisto
marotte | ŝatokupo
marteller | marteli
martell | martelo
marte | marto
masculin | maskla
mascul | masklo
ma | sed
masse | amaso
masticar | mastiki
mastic | mastiko
mast | masto
mastre | majstro
mastrisar | majstri
matinal | matena
matine | mateno
matrasse | matraco
matre | patrino
matrina | baptopatrino
matrin | patrina
matte | mato
maturar | maturiĝi
maturitá | matureco
matur | matura
maxille | makzelo
maxime | maksimo
max(im) | plej
may | majo
may | majo
meche | meĉo
medico | kuracisto, medicinisto
medie | medio
mediocri | mezvalora
med | pere de
melcar | melki
membre | membro
membritá | membreco
membrité | membraro
mem | eĉ
memorabil | memorinda
memorar | memori
memorie | memoro
menaciar | minaci
menacie | minaco
menagear | mastrumi
menage | mastrumaĵo
mendicar | almozi
mendico | almozulo
mensual | monata
mensu | monato
mental | mensa
mente | menso
mentie | mensogo
mentionar | mencii
mention | mencio
mentir | mensogi
menton | mentono
mercar | komerci
mercate | merkato
merce | komercaĵo
mercero | komercisto
mercurdí | merkredo
meriter | meriti
meritosi | merita
merle | merlo
mersiar | danki
mersí | danko
mersiosi | dank(em)a
mespil | mespilo
mesquin | tre malriĉa
messe | meso
mesura | mezuro
mesurar | mezuri
metalle | metalo
metallic | metala
metter | meti
miaular | mlaŭi
mica | glimo
micri | eta
midí | tagmezo
miel | mielo
migrar | migri
mild | delikata
miliari | mejla
milie | mejlo
militare | armeo
militari | armea
millennie | jarmilo
mill | mil
milz | laktumo
mimar | mimi
mi | mia
mimic | mima
mimo | mimo
mine | mino
minte | minto
minu | malpli
minuscul | minusklo
miracul | miraklo
miraculosi | mirakla
miserar | mizeri
misere | mizero
misser | sendi
mission | misio
mite | mito
mixter | miksi
mixtura | miksaĵo
mobilitá | moveblo
mobil | movebla
moble | meblo
mocada | mok(ad)o
mocar | moki
modellar | modeli
modelle | modelo
model | moda (verbo)
mode | modo
moderar | moderigi, mildigi
modestie | modesteco
modest | modesta
modic | malkara
moer | movi
mofar | ŝimi
mofa | ŝimo
molestar | molesti
molinar | mueli
moline | muelejo
moll | mola
mol | muelŝtono
molo | moleo
monaca | monahino
monaco | monaĥo
moné | mono
monete | monero
monir | admoni
monstrar | montri
monstru | monstro
monstruosi | monstra
montage | muntaĵo
montania | montaro
monte | monto
monter | munti
montette | monteto
monumental | monuinenta
monument | monuinento
morale | moralo
mordaci | mordema
morder | mordi
more | moro
morir | morti
morosi | moroza
mortar | mortigi
morte | morto
mort | morta
mortre | mortero
mosca | muŝo
mosquite | moskito
moss | musko
mostarde | mustardo
movement | movado
mover | movi
movette | mevo
muc | muko
mucosi | muka
mudde | koto
muff | mufo
muir | muĝi
mult | multe
mundal | monda
mundan | monduma
munde | mondo
munir | provizi
murage | masonaĵo
murar | masoni
murero | masonisto
murmurar | murmuri
mur | muro
musco | mosko
muscul | muskolo
mus | muso
mustache | lipharoj
mutar | mutacii
mutation | mutacio
mutilar | kripligi, mutili
mut | mute
mutualité | mutualeco
mutual | mutuala
najestic | majesta
nam | ĉar
nano | nano
narice | naztruo
nascer | naskiĝi
nase | nazo
nation | nacio
nativ | denaska
naufrage | ŝiprompo
nausea | naŭzo
nausear | naŭzi
nave | navo; ŝipo
navigar | navigi
navigation | navigado
nebular | nebuli
nebul | nebulo
nebulosi | nebula
necessi | necesa
necessitá | neceso
necos | nenio
necos | nenio
necú | nenie
necun | neniu
negar | nei
negation | neado (negacio)
negative | negativo
negativ | negativa
negligé | negliĝo
negligent | neglektema
negliger | neglekti
negociar | negoci
negociation | negoco
neologisme | neologismo
nepota | nepotino
nepote | nepoto
neproquó | nedankinde
nequal | nenia
nequam | neniel
nequande | neniam
nequant | neniom, tute nenio
nequel | neniu
nequí | neniu
nequó | nenio
nestar | nesti
nest | nesto
nett | neta
netto | nete
neva | nevino
nevo | nevo
niche | niĉo
nigrar | nigrigi
nigri | nigra
ni | nek, eĉ ne
ni … ni | nek … nek
nin | naŭ
nitre | salpetro
nivear | neĝi
nivell | nivelo
nive | neĝo
nobil | nobela
nobilo | nobelo
nobli | nobla
nocer | malutili
nociv | malutila
noctal | nokta
nocte | nokto
nodar | nodi
node | nodo
noi | ni
nominar | nomi
nómine | nomo
no! | ne!
nonna | monahino
nordic | nordlanda
nord | nordo
normal | normala
norme | normo
nor | nia
nos | nin, al ni
nostalgic | nostalgia
nostalgie | nostalgio
notar | noti
note | noto
noticie | notico
notion | nocio
notori | fama
novembre | novembro
novitá | novaĵo
nov | nova
nuanciar | nuanci
nuancie | nuanco
nube | nubo
nubosi | nuba
nuce | nukso
nucleari | nuklea
nucleo | nukleo
nuc | nuko
nud | nuda
null | neniu; nulo
numerar | numeri
númere | nombro
numeró | numero
numerosi | nombr(mult)-a
nu … nu | jen … jen
nu | nun
nuptie | nupto
nutriment | nutraĵo
nutrir | nutri
o | aŭ
obedient | obeema
obedir | obei
obesi | dika
obesitá | dik(ec)o
objecte | objekto
obje(c)ter | objeti
objective | objektivo
objectiv | objektiva
obligation | obligacio
obliger | obligacii
obliqui | oblikva
obliviar | forgesi
oblivie | forgeso
oblong | oblonga
obscen | obscena
obscur | obskura
obseder | obsedi
observar | observi
observator | observanto
obstacul | obstaklo, impediment
obstinaci | obstina
obstinar | obstini
obstructer | obstrukti
obstruction | obstrukto
obtener | obteni
obtus(i) | obtuza
ocasional | okaza
ocasionar | okazigi
ocasion | okazo
occidental | okcidenta
occident | okcidento
ocre | okro
octobre | oktobro
oculare(s) | okulvitro(j)
ocul | okulo
ocultisme | okultismo
ocult | okulta
ocupar | okupi
ocupation | okupo
odiar | malami
odie | malamo
odiosi | malama
odorar | odori
odore | odoro
ofender | ofendi
ofense | ofendo
oferta | oferto
ofertar | oferti
oficero | oficiro
oficiario | oficisto
oficie | ofic(ej)o
oficina | metiejo
ó | ho
oldesse | oldeco
old | olda, maljuna
olear | olei
oleo | oleo
ombrar | ombri
ombre | ombro
ómine | fatala antaŭsigno
omisser | ellasi
omni | ĉiuj
omnicos | ĉio
oncle | onklo
on | oni
o … o | aŭ, aŭ … aŭ
operar | operacii
operation | operacio
opiner | opinii
opinion | opinio
oponer | oponi
oportun | oportuna
oposition | opozicio
opresser | subprem(ad)i
opression | subprem(ad)o
optim | plej bona
opulentie | riĉeco
opulent | riĉa
orange | oranĝo
oratori | oratora
orator | oratoro
orbite | orbito
orden | ordeno
ordinar | ordigi
ordine | ordo
ordonar | ordoni
ordon | ordono
orel | orelo
orfan | orfano
organ | 1.organo 2.orgeno
orgollie | orgojlo
original | originala
originar | origini
orígine | origino
ornament | ornam(aĵ)o
ornar | ornami
ortografie | ortografio
oscillar | oscili
oscillator | oscililo
osse | osto
ostentar | ostenti
ostentativ | ostenta
ost | oriento
ostre | ostro
otie | mallaboro
ove | ovo
ovre | verko
pacca | pakaĵo
paccar | paki
pace | paco
paddlar | pagajli
paddle | pagajlo
padelle | pato, muldilo
pagano | pagano
paginar | paĝonumeri
págine | paĝo
paisage | pejzaĝo
país | kamparo
palace | palaco
palate | palato
paletó | palto
pal | fosto
palissade | palisaro
palisse | paliso
pallar | ŝoveli
paller | paliĝi
palle | ŝovelilo
pallid | pala
pallie | pajlo
palpabil | palpebla
palpar | palpi
palpebre | palpebro
pane | pano
pan(ific)ator | pan(bak)isto
panne | paneo
panse | ventraĉo
pantalon | pantalono
pantomime | pantomimo
papá | paĉjo
papa | papo
papavre | papavo
papegaye | papago
papere | papero
papilion | papilio
paradise | paradizo
parc | parko
parente | parento
parentese | parentezo
parent | parenta
pare | paro
pari | para
parlar | peroli
parocia | paroĥo
paroco | paroĥestro
parolórdine | vortordo
parol | vorto
parsimonie | avareco
part(e)nero | parulo, kunulo
parte | parto
partial | parta
participar | partopreni
participie | participo
particul | partikulo
partir | partigi
partisano | partiano
partise | partio
partú | ĉie
parturir | akuŝi, naski
Pascal | Paska
Pasca | Pasko
pasment | pasamento
passabil | mezbona, tolerebla
passage | pasejo
passagero | pasaĝero
pass(a)parol | pasvorto
passar | pasi
passional | pasia
Passione | Pasiono
passion | pasio
passport | pasporto
passuar | paŝi
passu | paŝo
pasta | pasto
pastero | paŝtisto
paster | paŝti
pastete | pasteĉo
patiente | paciento
patientie | pacienco
patient | pacienca
patinar | glitkuri
patine | glitkuro
patre | patro
patria | patrujo
patrino | baptopatro
patronatu | patroneco
patron | patrono
patte | manego
pave | pavimo
pavi | pavimi
pavon | pavo
payament | pago
payar | pagi
pecca | peko
peccar | peki
pech | peĉo
pectinar | kombi
péctine | kombilo
pectoral | brusta
péctor | brusto
pecunie | mono
pedale | pedalo
pede | piedo
pedicul | pediko
pejor | pli malbona
pelisse | pelto
pelissero | peltisto
pelle | haŭto
pelmel | pelmelo
pelote | fadenbulo
peloton | pelotono
pena | penado
penar | peni
pender | pendi
pendul | pendolo
penetrant | penetra
penetrar | penetri
peniter | penti
penosi | penega
pensa | penso
pensar | pensi
Pentecost | Penteksto
percentage | procentaĵo
percent | procento
percepter | percepti
perception | percepto
perde | perdo
perdir | perdi
perdonar | pardoni
perdrice | perdriko
peregrinage | pilgrimo
peregrinar | pilgrimi
peregrino | pilgrimanto
perfectionar | pliperfektigi
perfect | perfekta
perfid | perfida
perforar | perfori
periar | veti
perir | perei
perí | veto
perjurie | falsa ĵuro
permanent | daŭra
permaner | daŭri
permisser | permesi
permission | permeso
pernoctar | tranokti
perpendiculari | perpendikla
perpendicul | perpendiklo
perpetui | senĉesa
perplex | perpleksa
persecuter | persekuti
perseverar | elteni
persic | persiko
persister | persisti
persuader | persvadi
pertinent | deca
pertiner | deci
peruque | perako
perversi | perversa
pesa | pezo
pesar | pezi
pessim | plej malbona
peste | pesto
petida | peto
petir | peti
petition | peticio
petre | ŝtono
petrin | ŝtona
petrosel | petroselo
pezze | peco
pian(i) | mallaŭte
picar | piki
pic | pinto
picter | pentri
pictor | pentristo
pie | pia
pietá | pi(ec)o
piga | pigo
pigri | pigra
pilare | piliero
pilliar | rabi
pilorie | pilorio
pince | prenilo, tenajlo
pine | pino
pinglar | pingli
pingle | pinglo
pinne | naĝilo
pinselar | peniki
pinsel | peniko
piochar | pioĉi
pioche | pioĉo
pipiar | pepi, kviki, kviviti
pip | pipo
piprar | pipri
pipre | pipro
pire | piro
piscar | fiŝi
pisc | fiŝo
pise | pizo(j)
pissar | pisi
pistar | pisti
piston | piŝto
pistuore | pistujo
pivotar | pivoti
pivot | pivoto
plafon | plafono
plage | plaĝo
planca | planko
plani | ebena
plantar | planti
plante | planto
planura | ebenaĵo
plastre | plastro
platil | telero
plató | altplataĵo
plat | plata
plazza | placo; loko
plazzar | placo; loki
plecter | plekti
plenar | plenigi
plende | plendo
plendir | plendi
plen | plena
ples | bonvolu
pleser | plaĉi
plesura | plezuro
plica | faldo
plicar | faldi
plongear | plonĝi
plorada | ploro
plorar | plori
pluche | pluŝo
plugar | plugi
plug | plugilo
plumbe | plumbo
plumbin | plumba
plum | plumo
plu | pli
pluri | pluraj
pluviar | pluvi
pluvie | pluvo
poc a poc | iom post iom
poc | malmulta
poc | malmulte
poema | poemo
poete | poeto
poetic | poeta
polir | poluri
pollen | poleno
pollice | polekso, dikfingro
polve | polvo
pomiero | pomarbo
pom | pomo
ponderar | pezi
póndere | pezo
ponte | ponto
pople | poplo
populari | popola
popul | popolo
porco | porko
pore | poro
por | por
porro | poreo
porta | pordo
portar | porti
porte | afranko
portuari | havena
portu | haveno
posir | meti
pos | post
posseder | posedi
posser | povi
possession | posedaĵo
possessor | posedanto
possibil | ebla
posta | poŝto
posto | posteno
postular | postuli
postulate | postulo
potasse | potaso
potate | terpomo
potentie | potenco
potent | potenca
potte | poto
pottero | potfaristo
povri | povra, malriĉa
poy | poste, post tio
practica | praktiko
practic | praktika
pram | pramo
prate | herbejo
precepter | instrui
preceptor | instruisto
precie | prezo
precipitar | precipiti
precipue | precipe
preciser | precizi
precis | preciza
precoci | prematura
predica | prediko
predicar | prediki
preferentie | prefero
preferer | preferi
prefixe | prefikso
prega | prego
pregar | pregi
preliminari | anicipa
premisse | premiso
prender | preni
preparar | prepari
preparation | preparo
preposition | prepozicio
presc | preskaŭ
prescrir | preskribi
prescrition | preskribo
presentar | prezenti
present | ĉeesta
presentie | ĉeesto
preservar | ŝirmi
preservation | ŝirmilo
presidente | prezidanto
presider | prezidi
presse | preso
presser | presi
prestar | prunti
prestro | pastro
pretender | pretendi
pretensiosi | pretendema
préter | preter
pretexte | preteksto
pretexter | preteksti
pret | preta
pretti | bel(et)a
prevaler | superi, domini
preventer | preventi
prevention | prevento
primari | primara
primul | primulo
prim | unua
prince | princo
princessa | princino
principal | principa, ĉefa
principie | principo
printage | presajo
printar | presi
priori | entaŭa, eminenta, ĉefa
priorité | prioritato
pri | pri
prison | prizono, malliberejo
privar | senigi
probabil | probabla
procede | procedo
proceder | procedi
processu | proceso
proclamar | proklami
proclamation | proklamo
procrastinar | prokrasti
procurar | havigi
procuration | prokuro
procurator | prokuroro
prodigar | prodigi, malŝpari
producte | produkto
producter | produkti
profan | profana
professer | profesii
profession | profesio
profete | profeto
profetisar | profeti
profitar | profiti
profite | profito
profund | profunda
progresse | progreso
progresser | progresi
progressiv | progresa
projecte | projekto
projecter | projekti
prolongar | plilongigi
promenade | promeno
promenar | promeni
promesse | promeso
promesser | promesi
promoer | promocii
promotion | promocio
prompt | prompta
pronómine | pronomo
pronunciar | prononci
pronunciation | prononco
proportion | proporcio
proposir | proponi
proposition | propono
propri | propra
pro | pro
propulsion | movoforto
pro que | car; pro tio, ke
pro quo | pro kio, kial
prosperar | prosperi
prosperitá | prospero
protecter | protekti
protection | protekto
pro to | pro tio, tial
prova | provo
provar | provi
provenir | deveni, origini
proverbie | proverbo
provider | provizi
provision | provizo
proximmen | proksime
proxim | proksima
prudentie | prudento
prudent | prudenta
prud | pruda
prune | pruno
pruntar | pruntepreni
pruriter | juki
pruva | pruvo
pruvar | pruvi
psalm | psalmo
psaltre | psalmaro
psiche | psiĥo
púber | pubera
pubertá | pubereco
publica | publiko
publicar | publikigi
publicist | publicisto
public | publika
pudent | hontema
pudentie | hontemo
puder | honti
puella | bubino, knabino
puella | knabino
puer | knabo
pulce | pulo
pulmon | pulmo
pulular | svarmi
pululation | svarmo
púlvere | pulvoro
pulverisar | pulvorigi
púmice | pumiko
pumpar | pumpi
pumpe | pumpilo
punctuar | punkti
punctu | punkto
pund | pundo
punir | puni
punition | puno
punta | punto
puntar | puntigi
pupille | pupilo
puré | kaĉo
purgar | purigi, laksigi
pur | pura
pusilanim | etanima
pussar | puŝi
puteo | puto
putor | putoro
putrid | putra
putrir | putri
qualcunc | kia ajn
qualificar | kvalif(ik)i
qualitá | kvalito
qual | kia
qualmen | kiel
quamcunc | kiel ejn
quam | kiel
quandecunc | kiam ajn
quantitá | kvanto
quant | kiom
quarantene | kvaranteno
quar | kvar
quartale | jarkvarono, trimestro
quartere | kvartalo, loĝejo
quart | kvarono
quartz | kvarco
quasi | kvazaŭ
quast | kvasto
que | ke
quelc | kelke da, kelkaj
quelcunc | kiu ajn
quel | kiu
quem | kiun; al kiu
querc | kverko
querellar | kvereli
querelle | kverelo
questionar | demandi
question | demando
quicar | kviki
quicunc | kiu ajn
quiet | kvieta
qui | kiu
quincallia | merceraĵo
quin | kvin
quirlar | kirli
quittar | kvitiĝi
quitt | kvita
quocunc | kio ajn
quo | kio
quotidian | ĉiutaga
rabie | rabio
rabiosi | rabia
rabotar | raboti
rabot | rabotilo
raconta | rakonto
racontar | rakonti
radiation | radiado
radica | radiko
radie | radio
radio-aparate | radioaparato
radise | rafaneto
rafane | rafano
raffar | ekkapti
raftre | ĉevrono
ralar | raŭki
ramme | ram(il)o
rancid | ranca
rangear | vicigi
range | vico
rang | rango
ranin | rana
ran | rano
rapiditá | rapideco
rapid | rapida
raportar | raporti
raporte | raporto
rap | rapo
rapter | forrabi
raption | forrabo
raritá | raraĵo
rar | rara
rasar | razi
rason | 1.motivo 2.racio
rasuore | razilo
rational | racia
ration | racio
ratte | rato
rauc | raŭka
ravine | ravino
ravissent | rava
ravisser | ravi
reacter | reakcii
reaction | reakcio
realitá | realeco
real | reala
recenser | recenzi
recension | recenzo
recent | antaŭnelonga
recepter | akcepti
reception | akcepto
receptuar | recepti
receptu | recepto
recidive | remalsaniĝo
reciprocar | reciproki
reciproc | reciproka
recitar | reciti
recitation | recitaĵo
reciver | ricevi
recivibil | ricevebla
reclamar | reklamacii
reclamation | reklamacio
recoleer (se) | vigliĝi
recoltar | rikolti
recolte | rikolto
recomendar | rekomendi
recomendation | rekomendo
recompensar | rekompenci
recompensation | rekompenco
reconciliar | repacigi
reconciliation | repacigo
reconosser | rekoni
rect | rekta
recuperar | rekuperi
redempter | elaĉeti
reducter | redukti
reduction | redukto
reflecter | reflekti
reflection | reflekto
reflex | reflekso
reflute | malfluso
refracter | refrakti
refraction | refrakto
refrane | refreno, rekantaĵo
refrigerar | fridigi
refrigerator | fridujo
refriscament | refreŝigo
refriscar | refreŝigi
refugia | rifuĝejo
refugir | rifuĝi
refusa | rifuzo
refusar | rifuzi
refutar | refuti
regalar | regali
regale | regalo
regardar | rigardi
regarde | rigardo
regenerar | regeneri
regime | reĝimo
regisser | reĝisori
regissor | reĝisoro
regnar | regi
regnentie | regado
regresser | regresi
regress | regreso
regretar | bedaŭri
regrete | bedaŭro
regular | reguligi
regul | regulo
rejecter | forĵeti
relé | relajso
releter | rilati
reletion | rilato
religion | religio
rel | relo
remachar | remaĉi
remachar | remaĉi
remaner | resti
remarcar | rimarki
remarcebil | rimarkinda
remar | remi
remediar | rimedi
remedie | rimedo
rememorar | rememori
rememoration | rememoro
remise | remizo
remorse | rimorso
remplazzar | anstataŭi
rem | remilo
rendir | redoni
reniter | kontraŭstari
renovar | renovigi
renovation | renovigo
ren | reno
renunciar | renonci, rezigni (ion)
renversament | renverso
renversar | renversi
reparar | riperi
repartir | apartigi
repaste | manĝtempo
repenter | penti
repetir | ripeti
repetition | ripeto
reposar | ripozi
repose | ripozo
representar | reprezenti
represser | subpremi
reprimandar | admoni
reprochar | riproĉi
repter | rampi
reptile | rampulo, reptilio
repugnar | forpuŝi
repulser | malakcepti, rifuzi
repussar | repuŝi, forpuŝi
reputation | reputacio
residentia | rezidejo
resider | rezidi
resignar | rezigni
resignation | rezignacio
resine | rezino
resistentie | rezistanco
resister | rezisti
resoluer | decidi
resonar | resoni
resonation | resono
respectar | respekti
respecte | respekto
respirar | spiri
respiration | spirado
responder | respondi
responsabil | respondeca
responsar | respondeci
response | respondo
ressor | risorto
ressort | fako
ressurce | (helpa) fonto
restar | resti
restaurar | restaŭri
restauration | restaŭro
reste | resto
restituer | restitui
restoration | restoracio
gastería | hostalo
restrar | resti
restre | restilo
restricter | restrikti
resultar | rezulti
resultate | rezulto
resumar | resumi
resumé | resumo
retardar | malantaŭigi
retener | reteni
rete | reto
retine | retino
retornar | returni
retro | returne, reen
retuchar | retuŝi
retuche | retuŝo
revancha | repago
revanchar | repagi
revar | revi
revelar | revelacii
revelation | revelacio
revellie | veksignalo
revenida | reveno
revenir | reveni
revenú | enspezo
reve | rev(ad)o
reversar | reversi
reverse | reverso
revide | revido
revider | revidi
revocar | revoki
rey | reĝo
ricanament | rikano
ricanar | rikani
richesse | riceco
rich | rica
rider | ridi
ridicul | ridinda
riff | rifo
rigid | rigida
rimborse | remburso
rim | rimo
rinsar | gargari, tralavi
riscar | riski
risc | risko
risibil | ridinda
rision | rido
ris | rizo
ritme | ritmo
ritu | rito
rival | rivalo
rive | bordo
rivere | rivero
riverette | rivereto
rivetar | niti
rivete | nito
rixe | manbatalo, interbatiĝo
robinete | krano
robot | roboto
robust | dika, fortega
rocca | roko
roccosi | rokplena
roder | rodi
rol | rolo
rombe | rombo
roncar | ronki
ronde | rondo
rond | ronda
ronronar | ronroni
rosarium | rozario
rosé | roso
rose | rozo
rosi | roza
rospe | bufo
ross | rufa, ruĝhera
rostar | rosti
rotar | rotacii
rotation | rotacio
rote | rado
rubarbe | rabarbo
rubijar | ruĝ(ig)i
rubi | ruĝa
ructar | rukti
rucular | rukuli
rudiment | rudimento
rud | kruda
ruga | falto
rugir | kriegi
ruir | falruiniĝi
rular | ruli
rul | rulo
ruminar | remaĉi
rupter | rompi
rurano | kamparano
rure | kamparo
rustic | rustika
rute | vojo
rutine | rutino
sabre | sabro
sacrificar | oferi
sacrificie | ofer(aĵ)o
sacrilegie | sakrilegio
sacri | sakrala
sac | sako
sagaci | sagaca
sagi | saĝa
sagitá | saĝeco
salade | salato
salamandre | salamandro
salarie | salajro
salar | sali
sala | salono
sale | salo
salice | saliko
salient | okulfrapa
salin | salita
salivar | salivi
salive | salivo
salmon | salmo
salpetre | salpetro
salsice | kolbaso
saltar | salti
salta | salto
salubri | salubra
salutar | saluti
salutation | saluto
salvar | savi
salvation | savo
salve | salvo
sam | sama
sand | sablo
sanguar | sang(ad)i
sangue | sango
sanguisuc | hirudo
sanitá | sano
san | sana
santificar | sankti
sant | sankta
sapatero | ŝuisto
sapate | ŝuo
saper | gusti
saponar | sapumi
sapon | sapo
saporosi | bongusta
sappero | sapeisto
sappe | sapeo
sarclage | sarkaĵo
sarclar | sarki
sarco | ĉerko
satisfar | kontentigi
sat | sufiĉe
saturar | satigi
saturdí | sabato
satur | sata
sauce | saŭco
savagi | sovaĝa
saver | scii
savurar | ĝui
scabelle | skabelo
scabie | skabio
scafalde | skafaldo
scaf | ŝranko
scale | l.skalo 2.ŝtupetaro
scaliere | ŝtuparo
scarabé | skarabo
scarlat | skarlato
scarp(at) | kruta
scatulle | skatolo
sceptre | sceptro
scientic | scienca
scientie | scienco
scientist | scienculo
scintille | fajrero, (el.) sparko
sclave | sklavo
scluse | akvobaraĵo, flu-baro
scola | lernejo
scole | skolo
scope | celo
scorbut | skorbuto
scorie | skorio
scrappar | skrapi
scren | ekrano
scrir | skribi
scrition | skribado
scritura | skribo
scroful | skrofulo
scrupulosi | skrupula
scrupul | skrupulo
scruvar | ŝraŭbi
scruve | ŝraŭbo
scude | ŝildo
sculpter | skulpti
sculptor | skulptisto
scumar | ŝaŭmi
scum | ŝaŭmo
scurel | sciuro
sebe | sebo
secale | sekalo
secluder | apartigi
seconde | sekundo
secreer | sekrecii
secretario | sekretario
secrete | sekreto
secretion | sekrecio
secret | sekreta
sectano | sektano
secta | sekto
secter | (dis)sekci
section | (dis)sekco
secuer | sekvi
sécul | jarcento, centjaro
secundari | sekundara
secund | dua
secun | laŭ
securar | sekurigi
secur | sekura
seder | sidi
sede | sidejo
sedlar | seli
sedle | selo
seducter | delogi
segar | segi
sega | segilo
seglar | velveturi
segle | velo
segment | segmento
sejornar | restadi
sejorne | restado
selecter | selekti
selection | selekto
self | mem
semanal | semajna
semane | semajno
semar | semi
semblantie | ŝajno
semblar | ŝajni
seme | semo
semi | duon
sempre | ĉiam
seniora | sinjorino
senior | sinjoro
sense | senco
sensibil | sentema
sensual | sensa
sensu | senso
sente | sento
sentibil | sentebla
sentir | senti
separar | separi
separation | separo
septembre | septembro
septic | putra
sepulter | sepulti, entombigi
sequentie | sinsekvo
sequer | sekvi
sequer | sekvi
serchar | serĉi
seren | serena
sergente | serĝento
seriosi | serioza
serpente | serpento
serpentin | serpenta
serrar | kunpremi
serrette | premtenilo
serrure | seruro
service | servico
servicie | servo, deĵoro
serviette | buŝtuko
servir | servi
servitor | servisto
servitute | servuto
servo | senreptulo, servitulo
se | sin
session | sesio
sete | soifo
sett | sep
severi | severa
sexual | seksa
sexu | sekso
sibilar | sibli
siccar | sekigi
sicc | seka
sifflar | fajfi
sigill | sigelo
signar | signi
signe | signo
significar | signifi
silentie | silento
silent | silenta
silkin | silka
silk | silko
sillabar | silebi
sillabe | silebo
simie | simio
similar | simili
similitá | simileco
simil | simila
simplic | simpla
simplificar | simpligi
simular | simuli
simultan | samtempa
sinap | sinapo
sinceri | sincera
sindicate | sindikato
singlutar | plorsingulti
singulare | singularo
singul | unuopa
sinistri | sinistra
sinlabor | senlabora
sin | sen
sinu | sino
sirotar | sorbi
si | se
sisme | tertremo
sitell | sitelo
situar | situi
situation | situacio
sive … sive | aŭ … aŭ
six | ses
slamm | ŝlimo
slifar | akrigi
slifuore | akrigilo
sling | ĵetilo
slittar | sledi
slitte | sledo
smeril | smirgo
sobri | sobra
social | socia, sociala
societé | asocio, societo
socio | kunulo
socle | soklo
soflar | blovi
solari | suna
solea | ŝu-plando
soledí | dimanĉo
solemni | solena
sole | suno
solicitar | pretendi
solidari | solidara
solidaritá | solidareco
solid | solida
solitá | soleco
sol | sola
soluer | solvi
solution | solv(aĵ)o
sommit | supro, pinto
somniar | sonĝi
somnie | sonĝo
sonar | soni
sondar | sondi
sonde | sondilo
son | sono
sordid | sordida
sorte | speco
sospirar | suspiri
sospire | suspiro
sovente | ofte
spacial | spaca
spacie | spaco
spadar | fosi
spade | fosilo
sparro | pasero
special | speciala
specie | specio
specimen | specimeno
spectar | spekti
spectator | spektanto
spegul | spegulo
spica | spiko
spice | spico
spinace | spinaco
spin-crusbere | groso
spin-crusbere | groso
spindle | spindelo
spine | dorno
spine dorsal | spino
spingle | pinglo
spinosi | dornoplena
spionar | spioni
spion | spiono
spirar | spiri
spira | spiro
spirite | spirito
spíritu | menso, spirito
splender | brili
splendid | belega
splinte | ŝtipo
splittre | lignero, splito
spoliar | priŝteli
sponder | fianĉi
spongie | spongo
sponsa | fianĉino
sponso | fianĉo
spontan | spontana
sporadic | sporada
sporne | sprono
sprite | alcoholo
spruzzar | ŝpruci
spul | bobeno
sputar | sputi
squame | skvamo
squelette | skeleto
squermar | skermi
stabilisar | stabiligi
stabil | stabila
stalin | ŝtala
stalle | stalo
stal | ŝtalo
stampar | stampi
stampe | stampaĵo
stamp | stampilo
standarde | normo
standardisar | normigi
standar | farti
standarte | standardo
stanno | stano
star | stari
statal | ŝtata
state | ŝtato
station | stacio, stacidomo
statmann | ŝtatviro
statuer | starigi
statue | statuo
statu | stato
stellari | stela
stelle | stelo
stercar | sterki
sterco | sterko
sterilisar | steriligi
steril | sterila
sternutar | terni
stil | stilo
stimular | stimuli
stimul | stimulo
stípite | pedunklo
stirar | stiri
stir | stirilo
stock | stoko
stoff | ŝtofo
stoicisme | stoikismo
stoic | stoika
stomacal | stomaka
stomac | stomako
stoppar | stopi, haltigi
storc | cikonio
storm | ŝtormo
stove | stovo
strabar | strabi
strade | streto
stradette | streteto
strangi | stranga
stranguler | strangoli
strapaciar | klopodi
strapacie | klopodo
strap | rimeno
strate | tavolo
strax | tuj
strecar | streki
strec | streko
strett | mallarĝa
strict | strikta
stridant | strida
strider | stridi
strie | strio
strigular | strigli
strip | piedingo
struce | strumo
struma | strumo
strumpe | ŝtrumpo
stuccar | stuki
stucca | stuko
studiar | studi
studie | studado
stuffar | remburi
stul | seĝo
stulton | stultulo
stult | stulta
stump | stumpo
stuppe | stupo
sturne | sturno
suavi | agrabla, ĉarma
subir | submetiĝi
subit | subita
subjecte | subjekto
subjectiv | subjektiva
subjugar | (sub)jugi
sublim | sublima
submerser | mergi
submetter | submeti
subordinar (se) | subordigi (sin)
subride | rideto
subrider | rideti
subscrir | subskribi
subsidiar | subteni
subsidie | subteno
substantie | substanco
substantive | substantivo
substituer | substitui
substoff | subŝtofo
substrecar | substreki
sub | sub
subtasse | pleto
subtener | subteni
subterran | subtera
subtil | subtila
subtraer | subtrahi
suburbe | antaŭurbo
subvention | subvencio
sucar | suĉi
succeder | sekvi
successor | sekvanto
success | sukceso
succ | suko
succurse | helpo, subteno
suciar | zorgi
sucie | zorgo
sucon | suĉinfano
sucrage | sukeraĵo
sucre | sukero
sucumber | sperti malvenkon
sucusser | skui
sucusse | skuo
sudar | ŝviti
sudic | suda
sudore | ŝvito
sud | sudo
suer | kudri
suficer | sufiĉi
sufixe | sufikso
suflar | suflori
suflé | sufleo
sufocar | sufoki
sufragie | elektorajto
sufrentie | sufero
sufrer | suferi
suggester | sugesti
suggestion | sugesto
suicidie | sinmortigo
sulcar | sulki
sulca | sulko
suldar | luti
sulfuric | sulfura
sulfur | sulfuro
summar | sumigi
summa | sumo
suol | tero, grundo
supear | vespermanĝi
superar | superi
superb | superba, belega
superficial | surfaca
superficie | surfaco
superfluer | superflui
superflú | superflua
superiori | supera
supersticie | superstiĉo
supersticiosi | superstiĉa
súper | super
supervider | supervidi
supervision | supervido
supé | vespermanĝo
supiere | supujo
suplement | suplemento
supliciar | mortpuni
suplicie | mortpuno
suportar | apogi
suporte | apogo
suposir | supozi
suposition | supozo
supra | supre
supresser | subpremi
sup | supo
surdimut | surdmuta
surd | surda
sure | suro
surprisar | surprizi
surprise | surprizo
sur | sur
surtida | eliro
surtir | eliri
su | sia, lia, ŝia, ĝia
suspecter | suspekti
suspection | suspekto
suspect | suspekta
suspender | eksigi
suspension | eksigo
susurrar | susuri
sution | kudrado
sutura | kudraĵo
suvenire | memoraĵo
svelt | svelta
svimmar | naĝi
svinin | porka
svin | porko
tabane | tabano
table | tablo
tabulette | tabuleto
tabul | tabulo
tacentie | silento
tacer | silenti
tachar | taski
tache | tasko
taciturn | silentema
tactar | takti
tacte | takto
talc | talko
táler | talero
talliar | tajli
talliero | tajloro
tallie | tajlo
talmen | tiamaniere
talon | kalkanumo
talpe | talpo
tal | tia
tamburar | tamburi
tambur | tamburo
tamen | tamen
tampar | stopi
tampon | stopilo
tam | tiel
tande | tiam
tannar | tani
tannine | tan(in)o
tanta | onklino
tant | tiom
tapetar | tapeti
tapete | tapeto
tapisse | tapiŝo
taponar | ŝtopi
tapon | ŝtopilo
tappar | esti malcerta
tard | malfrua, tarda
tarif | tarifo
tarine | fringelo
tarte | torto
tasca | poŝo
tasse | taso
taste | klavo
ta | tien
tatuar | tetui
tauro | taŭro
taverne | taverno
taxon | melo
teatre | teatro
te | cin, al ci
tegment | tegmento
tegul | tegolo
tema | temo
tematic | tema
temperar | moderigi
tempeste | tempesto
tempe | vetero
tempie | tempio
temple | templo
tempore | tempo
tempo | takto, ritmo, rapid(ec)o
tenaci | obstina
tenda | tendo
tendentie | tendenco
tendentiosi | tendenca
tender | streĉi
tendon | tendeno
tendri | tenera
tenebre | tenebro, mallumo
tener | teni
tenette | tenilo
tenia | tenio
tenon | tenono
tension | streĉo, tensio
tentar | tenti
tentation | tento
tenui | maldika
tepid | tepida
terebint(in)e | terebinto
terme | termofonto
terminar | termlimi
termine | termlimo
termino | termino
terra | tero
terren | tereno
terrer | teruri
terribil | terura
terrorisar | teroradi
terror | teroro
ters | triono
tese | tezo
testament | testamento
testar | testi
testimon | atestanto
testimoniar | atesti
testimonie | atesto
test | testo
té | teo
tette | mampinto, cico
textero | teksisto
texter | teksi
textual | teksta
textu | teksto
tic | 1.tiko 2.iksodo
ti (ci) | tiu (ĉi)
ticlar | tikli
tic-tacament | tiktako
tic-tacar | tiktaki
tif | tifo
til | ĝis
tilie | tilio
timbale | timbalo
timer | timi
timid | timema
timon | timono
timore | timo
timpane | timpano
tindre | tindro
tinea | tineo
tine | tino
tinter | tinkturi, farbi
tintlnar | tinti
tipic | tipa
tippar | frapeti
tip | tipo
típul | kulo
tiranne | tirano
tirannissr | tirani
tirar | 1.tiri 2.pafi
titillar | tikli
titular | titoli
titul | titolo
toale | mantuko
toffe | tufo
tolerabil | tolerebla
tolerant | tolerema
tolerar | toleri
tomberia | tombejo
tombe | tombo
tom | volumo
tonder | tondi
tonnage | tunaro
tonnerar | tondri
tónnere | tondro
tonne | tuno
tonsille | tonsilo
tonsura | tond(ad)o
torax | torako
torche | torĉo
torder | tordi
torfe | torfo
tormentar | tormenti
tormente | tormento
tornar | torni
tornuore | tornilo; turni
torrente | torento
torsion | tord(ad)o
torte | torto
tortug | testudo
torturar | torturi
tortura | torturo
tost | frua
totala | totala
to | tio
tot | tuta
toxic | toksa
traché | traĥeo
traciar | tracei
tracie | traceo
tractar | trakti
tractate | traktaĵo
tradir | transdoni
traditional | tradicia
tradition | tradicio
traducter | traduki
traduction | traduko
traer | treni
trafic | trafiko
trahir | perfidi
trahition | perfido
tramp | trampo
tranchar | tranĉi
tranquilisar | trankviligi
tranquilitá | trankvilo
tranquil | trankvile
transacter | transakcii
transaction | transakcio
transcendent | transcenda
transformar | transformi
transformator | transformatoro
transfuser | transfuzi
transfusion | transfuzo
transgresser | transpaŝi
transir | transiri
transition | transiro
transitiv i tranzitiva (verbo)
translater | traduki
translation | traduko
translocar | transloki
translocation | transloko
transmisser | transmisii
transmission | transmisio
transparent | diafana
transplantar | transplanti
trans | trans
transversal | transversa
transversar | transverŝi
trappe | kaptilo
trate | trajto
tra | tra
tratte | trato
traverse | transtrabo
travestir | alivesti
trave | trabo
trellie | krado
trema | (tim)tremo
tremer | tremi, skui
tremore | tremiĝo
tremul | tremolo
trenar | treni
trenché | tranĉeo
tren | trajno, vagonaro
tresor | trezoro
tressar | harplekti
tresse | harplekto
tre | tre
tribe | tribo
tribuer | imposti
tribular | turmenti
tribunale | tribunalo
tricotage | trikotaĵo
tricot | trikoto
tric | truko
trifolie | trifolio
trillar | trili
trill | trilo
trincage | trinkaĵo
trincar | trinki
trinitá | triopo
tristesse | tristo
trist | trista
tri | tri
triturar | pecetigi
trivial | triviala
trofé | trofeo
trombe | trombo
trompe | rostro
tronar | troni
tron | trono
tropes | tropikzono
tropic | tropika
tro | tro
trottar | troti
trottuore | trotuaro
trovar | trovi
trubli | malklara
truffle | trufo
trump | atuto
trumpetar | truapeti
trumpete | truapeto
trunc | trunko
trute | truto
tsar | caro
tsaressa | carino
tuberculose | tuberkulozo
tubercul | tuberkulo
túbere | tubero
tube | tubo
tuchar | tuŝi
tu | ci
tui | cia
tulip | tulipo
tumer | ŝveli
tumore | ŝvelaĵo, tumoro
tumul | tumulo
tumultu | tumulto
turbar | perturbi, ĝeni
turbine | turbino
turdo | turdo
turre | turo
turtur | turto
tussar | tusi
tusse | tuso
tussilago | tusilago
tutear | ci-diri
tutor | kuratoro, protektoro
ubiqui | ĉie(est)a
ucunc | kieajn
u | kie
ulcere | ulcero
ul | strigo
ulteriori | plua
ultim | lasta
ultra | krom, escepte de
ulular | ululi
unaltru | reciproke
unbilico | unbiliko
uncie | unco
uncter | ŝmiri
undear | ondi
unde | ondo
undular | ondumi
unesim | unua
ungul | ungo
union | unio
unir | unuigi
unitá | unueco
un poc | iom
unquande | iam, foje
unquente | ungvento
un | unu
unvez | unuoble, unufoje
up | supren
uragane | uragano
urgent | urĝa
urger | urĝi
urine | urino
urogallo | urogalo
uro | uro
ursin | ursa
urso | urso
urtica | urtiko
usada | uzado
usar | uzi
usa | uzo
usina | uzino
usual | kutima
usu | kutimo
usure | uzuro
utensile | ilaro
utilisar | utiligi
util | utila
uve | grapolo, (vin)beraro
uvul | uvulo
vacantie | ferio, libertempo
vacant | vakanta
vacar | vaki
vacca | bovino
vaccello | bovido
vaccinar | vakcini
vaccine | vakcino
vaccinie | vakcinio
vacilar | trembrili
vacuar | vakui
vacui | vakua
vacuum | vakuo
vada | vadejo
vader | iri
vaffle | vaflo
vagard | vegulo
vagar | vegi
vaginal | vagina
vagine | vagino
vag | nedifinita, necerta
vagon | vagono
valer | validi
validitá | valideco
valid | valida
valise | valizo
valley | valo
vall | remparo
valore | valoro
valute | valuto
valve | valvo
vaniglorie | vanteco
vanitari | vant(em)a
vanitá | vaneco
vanitosi | vant(em)a
van | vana
vapor-nave | vaporŝipo
vapor | vaporo
variabil | variebla
varicelle | varicelo
varice | variko
varietá | diverseco
varie | varie
variole | variolo
vase | vazo
vassale | vasalo
vast | vasta
va | (vorto uzata antaŭ infinitivoj por esprimi li estontecon) 
yo va far | mi faros
vegetariane | vegetarano
vegetar | vegeti
vehement | energia
vehicular | vehikli
vehicul | vehiklo
veler | vuali
vele | vualo
vell | (vorto uzata antaŭ infinitivoj por esprimi li kondicionalon)
yo vell far | mi farus
veloci | rapida
velur | veluro
vende | vendo
vendibil | vendebla
vendir | vendi
venen | veneno
venerdí | venoredo
venerer | honori
vene | vejno
venir | veni
venjar | venĝi
venja | venĝo
vente | vento
ventol | ventumilo
ventosi | venta
ventre | ventro
ventricul | ventriklo
verbe | verbo
verdeer | verdiĝi
verdicte | verdikto
verdi | verde
verge | vergo
verificar | verificar
veritá | vero
vermaatri | vermohava
vermae | vermo
vernal | printempa
verne | printempo
vernisse | verniso
versar | verŝi
vers | directe al
verse | verso
versificar | versi
versimil | verŝajna
verso | antaŭa flanko
vertebre | vertebro
verter | reversi
vertical | vertikala
vertice | vertico
vertigine | vertiĝo
vertuosi | virta
vertú | virto
veruca | veruko
ver | vera
verve | vervo
vesicul | veziketo
vesperal | vespera
vesper | vespero
vespe | vespo
vessica | veziko
veste | vesto
vestigie | vestiĝo
vestir | vesti
veterinario | veterinaro
vettar | vati
vette | vato
ve! | ve!
vexar | turmenti
vez: du vez | duoble
viaducte | viadukto
viagear | vojaĝi
viage | vojaĝo
viarium | horaro, horlibro
via | vojo
vicario | vikario
vice | anstataŭ
vicear | anstataŭigi
vicie | malvirto
vicinitá | najbareco
vicin | najbara
vicino | najbaro
viciosi | malvirte
victer | venki
victime | viktimo
victorie | venko
victor | venkinto
victuales | nutraĵoj
vider | vidi
vidua | vidvino
viduo | vidvo
viger | esti vitala
vigilar | vigli
vigil | vigla
vigore | vivpotenco
vilan | fia
vili | malnobla
villagean | vilaĝa
village | vilaĝo
vinagre | vinagro
viniera | vinberejo
viniette | vinjeto
vin | vino
violentar | violenti
violent | violenta
violette | violo
violine | violono
vípere | vipero
virago | vira virino
virgina | virgino
viril | vira
virle | akvo-vortico, ventovortico
virtual | ŝajna, kvazaŭa, inaga
visage | vizaĝo
visa | vizo
visceres | visceroj
viscosi | viskoza
visette | celgrajno
vise | vizio
visibil | videbla
visitar | viziti
visitation | vizito
visivitá | vidkapablo
vista | vidaĵo
vitalitá | vitaleco
vital | vitala
vite | vito
vitre | vitro
vitrine | vitrino, vitroŝranko
vivaci | vivema
viver | vivi
vive | vivo
vi | vidu, jen
vivificar | revivigi
vivipari | vivonaska
vocale | vokalo
vocar | voki
voce | voĉo
voer | promesi, voti
volar | flugi
volentie | volo
voler | voli
voluer | volvi
volume | volumo
volúmine | volumeno
voluntari | volonta
voluntá | volonteco
voluptá | volupto
vomir | vomi
voraci | vorema
vorar | vori
vor | via
vos | vin, al vi
votar | voĉdoni
vrec | ŝipruino
vulcane | vulkano
vulgari | vulgara
vulnerar | vundi
vúlnere | vundo
vultar | volbigi
vulte | volbo
vultur | vulturo
vu | vi
watt | vato, vatto
west | okcidento
whisky | viskio
wist-lude | vistludo
wist | vistludo
xenolexico | fremdvortaro
xilofon | ksilofono
xilografie | ksilografio
X-radies | x-radioj, iks-radioj
yacht | jaĥto
ya | ja
yarn | jarno, ŝpinfadeno
ye | je
yelb | flava
yellar | jelpi
yeral | hieraŭa
yer | hieraŭ
yes | jes
yodlar | jodli
yoll | jolo
yo | mi
yufte | jufto
yunesse | yuneco
yuno | yunulo
yun | yuna
zebre | zebro
zefire | zefiro
zenite | zenito
zig-zag | zigzaga
zinc | zinko
zingibre | zingibro
zóbol | zibelo
zodiac | zodiako
zone | zono
